00	00	00	00	00	00	00	00	00	00	00	00	00	00	00	00	00	00	00	00	00	00	00	00	00	00	00	00	00	00		
06	02	02	02	02	02	03	02	02	02	02	02	02	00	00	02	02	02	02	02	02	02	02	03	02	02	02	02	07	00		
06	00	00	00	11	00	00	00	00	00	00	00	12	00	00	11	00	00	00	00	00	00	00	24	14	00	00	00	07	00		
06	00	00	01	02	02	03	02	04	00	00	01	02	02	03	02	02	04	00	00	01	02	02	03	02	04	00	00	07	00		
06	00	00	00	00	00	22	00	00	00	00	00	00	00	23	00	12	00	00	00	00	00	00	00	00	00	00	00	07	00		
06	00	00	01	02	02	03	02	04	00	00	01	02	02	03	02	02	04	00	00	01	02	02	03	02	04	21	00	07	00		
06	00	00	00	15	00	25	00	00	00	00	00	15	00	00	00	00	00	00	00	00	00	00	00	00	00	00	00	07	00		
06	00	00	01	02	02	03	02	04	00	00	01	02	02	03	02	02	04	00	00	01	02	02	03	02	04	00	00	07	00		
06	00	00	00	00	00	00	00	00	00	00	00	00	00	23	00	00	00	00	00	00	00	00	24	00	00	00	00	07	00		
06	00	00	01	02	02	03	02	04	00	00	01	02	02	03	02	02	04	00	00	01	02	02	03	02	04	00	00	07	00		
06	00	00	00	14	00	22	00	00	00	00	00	13	00	22	00	00	00	00	00	00	00	00	22	13	00	00	00	07	00		
05	21	00	05	05	05	05	05	05	21	00	05	05	05	05	05	05	05	21	00	05	05	05	05	05	05	21	00	05	00		
