00 04 04 04 04 04 04 04 02 02 04 04 04 04 04 04 04 04 04 04 04 04 04 04 04 00 04
00 04 04 04 04 04 04 04 04 04 04 04 04 04 04 04 04 04 04 04 04 04 04 04 04 00 04
00 04 01 02 03 02 02 03 07 07 01 02 03 02 02 03 04 04 01 02 03 02 03 04 04 00 04
00 04 04 04 04 04 04 04 07 07 04 04 04 04 04 04 04 04 04 04 04 04 04 04 04 00 04
00 04 01 02 03 02 02 03 07 07 01 02 03 02 02 03 04 04 01 02 03 02 03 04 04 00 04
00 04 04 04 04 04 04 04 07 07 04 04 04 04 04 04 04 04 04 04 04 04 04 04 04 00 04
00 04 01 02 03 02 02 03 07 07 01 02 03 02 02 03 04 04 01 02 03 02 03 04 04 00 04
00 04 04 04 04 04 04 04 07 07 04 04 04 04 04 04 04 04 04 04 04 04 04 04 04 00 04
00 04 01 02 03 02 02 03 07 07 01 02 03 02 02 03 04 04 01 02 03 02 03 04 04 00 04
00 04 04 04 04 04 04 04 07 07 04 04 04 04 04 04 04 04 04 04 04 04 04 04 04 00 04
00 04 01 02 03 02 02 03 07 07 01 02 03 02 02 03 04 04 01 02 03 02 03 04 04 00 04
00 04 04 04 04 04 04 04 07 07 04 04 04 04 04 04 04 04 04 04 04 04 04 04 04 00 04
05 05 05 05 05 05 05 05 08 08 05 05 05 05 05 05 05 05 05 05 05 05 05 05 05 05 05
05 05 05 05 05 05 05 05 05 05 05 05 05 05 05 05 05 05 05 05 05 05 05 05 05 05 05