04 04 04 04 04 04 04 04 04 04 04 04 04 04 04 04
04 04 04 04 04 04 04 04 04 04 04 04 04 04 04 04
04 04 04 04 04 04 04 04 04 04 04 04 04 04 04 04
04 04 04 04 04 04 04 04 04 04 04 04 04 04 04 04
04 04 04 04 04 04 04 04 04 04 04 04 04 04 04 04
04 04 04 04 04 04 04 04 04 04 04 04 04 04 04 04
04 04 04 04 04 04 04 04 04 04 04 04 04 04 04 04
04 04 04 04 04 04 04 04 04 04 04 04 04 04 04 04
02 02 02 02 02 02 02 02 02 02 02 02 02 02 02 02
02 02 02 02 02 02 02 02 02 02 02 02 02 02 02 02
02 02 02 02 02 02 02 02 02 02 02 02 02 02 02 02
02 02 02 02 02 02 02 02 02 02 02 02 02 02 02 02
02 02 02 02 02 02 02 02 02 02 02 02 02 02 02 02
02 02 02 02 02 02 02 02 02 02 02 02 02 02 02 02
02 02 02 02 02 02 02 02 02 02 02 02 02 02 02 02
02 02 02 02 02 02 02 02 02 02 02 02 02 02 02 02
02 02 02 02 02 02 02 02 02 02 02 02 02 02 02 02
01 00 03 04 04 04 04 04 04 04 04 04 04 03 01 02 
01 01 03 03 03 03 03 03 03 03 03 03 03 03 02 00 
01 02 03 03 03 03 03 03 03 03 03 03 03 03 00 01 
01 00 03 03 00 01 02 00 01 02 00 03 03 03 01 02 
01 01 03 03 01 03 03 01 02 00 01 03 03 03 02 00 
01 02 03 03 02 03 03 02 00 01 02 03 03 03 00 01 
01 00 03 03 00 01 02 00 01 02 00 03 03 03 01 02 
01 01 03 03 04 04 04 03 02 00 01 03 03 03 02 00 
01 02 03 03 03 03 03 03 00 01 02 00 01 02 00 01 
01 00 01 02 00 01 02 00 01 02 00 01 02 00 01 02 
04 04 04 04 04 04 04 04 04 04 04 04 04 04 04 04
02 02 02 02 02 02 02 02 02 02 02 02 02 02 02 02
01 00 03 04 04 04 04 04 04 04 04 04 04 03 01 02 
01 01 03 03 03 03 03 03 03 03 03 03 03 03 02 00 
01 02 03 03 03 03 03 03 03 03 03 03 03 03 00 01 
01 00 03 03 00 01 02 00 01 02 00 03 03 03 01 02 
01 01 03 03 01 03 03 01 02 00 01 03 03 03 02 00 
01 02 03 03 02 03 03 02 00 01 02 03 03 03 00 01 
01 00 03 03 00 01 02 00 01 02 00 03 03 03 01 02 
01 01 03 03 04 04 04 03 02 00 01 03 03 03 02 00 
01 02 03 03 03 03 03 03 00 01 02 00 01 02 00 01 
01 00 01 02 00 01 02 00 01 02 00 01 02 00 01 02 
04 04 04 04 04 04 04 04 04 04 04 04 04 04 04 04
02 02 02 02 02 02 02 02 02 02 02 02 02 02 02 02
01 00 03 04 04 04 04 04 04 04 04 04 04 03 01 02 
01 01 03 03 03 03 03 03 03 03 03 03 03 03 02 00 
01 02 03 03 03 03 03 03 03 03 03 03 03 03 00 01 
01 00 03 03 00 01 02 00 01 02 00 03 03 03 01 02 
01 01 03 03 01 03 03 01 02 00 01 03 03 03 02 00 
01 02 03 03 02 03 03 02 00 01 02 03 03 03 00 01 
01 00 03 03 00 01 02 00 01 02 00 03 03 03 01 02 
01 01 03 03 04 04 04 03 02 00 01 03 03 03 02 00 
01 02 03 03 03 03 03 03 00 01 02 00 01 02 00 01 
01 00 01 02 00 01 02 00 01 02 00 01 02 00 01 02 