00 04 04 04 04 04 04 04 04 02 02 02 02 02 02 04 04 04 04 04 04 04 04 04 04 04 04 05 04 04 00 04
00 04 04 04 04 04 04 04 04 04 04 04 04 04 04 04 04 04 04 04 04 04 04 04 04 04 06 05 04 04 00 04
00 01 01 01 02 03 02 02 03 04 04 01 02 03 02 02 03 04 04 01 02 03 02 03 04 04 06 05 04 04 00 04
00 04 04 04 04 04 04 04 04 04 04 04 04 04 04 04 04 04 04 04 04 04 04 04 04 04 06 05 04 04 00 04
00 04 04 01 02 03 02 02 03 04 04 01 02 03 02 02 03 04 04 01 02 03 02 03 04 04 06 05 04 04 00 04
00 04 04 04 04 04 04 04 04 04 04 04 04 04 04 04 04 04 04 04 04 04 04 04 04 04 06 05 04 04 00 04
00 04 04 01 02 03 02 02 03 04 04 01 02 03 02 02 03 04 04 01 02 03 02 03 04 04 06 05 04 04 00 04
00 04 04 04 04 04 04 04 04 04 04 04 04 04 04 04 04 04 04 04 04 04 04 04 04 04 06 05 04 04 00 04
00 04 04 01 02 03 02 02 03 04 04 01 02 03 02 02 03 04 04 01 02 03 02 03 04 04 06 05 04 04 00 04
00 04 04 04 04 04 04 04 04 04 04 04 04 04 04 04 04 04 04 04 04 04 04 04 04 04 06 05 04 04 00 04
05 08 08 05 05 05 05 05 05 08 08 05 05 05 05 05 05 05 05 05 05 05 05 05 08 08 05 05 04 00 00 00 
05 05 05 05 05 05 05 05 05 05 05 05 05 05 05 05 05 05 05 05 05 05 05 05 05 05 05 05 04 04 00 04